NO ./textures/walls/wall.xpm
SO ./textures/walls/wall.xpm  
WE ./textures/walls/wall.xpm
EA ./textures/walls/wall.xpm

F 220,100,0
C 0,0,255

        1111111111111111111111111
        1000000000110000000000001
        1011000001110000000000001
        1001000000000000000000001
111111111011000001110000000000001
100000000011000001110111110111111
11110111111111011100000010001
11110111111111011101010010001
11000000110101011100000010001
10000000000000000000000010001
10000000000000001101010010001
11000001010101011111011110N0111
11110111011101010101111010001
11111111111111111111111111111 